1111111111111
1A00000000001
1011111100101
1010000100101
1011011110101
1000010000001
1011011110001
1000000000001
1011111111101
1000000000001
1011111111101
1010001000101
10001000100B1
1111111111111