111111111
1A0000001
101111101
101000001
101111101
100001001
101111101
1000000B1
111111111