1111111111
1A00000001
1011111101
1010000101
1011011101
1010000101
1011011101
1000000B01
1111111111