111111111
1A0000001
101111101
101000001
101111101
101000001
101101101
1000010B1
111111111